WORDMAP_LETTERS = [["P","S","S","S","S","S","S","S","S","S","S","S","S","S","S","S","S","S","S","S","S","S","S","S","S","S","S","S","S","S","S","S","S","S","S","S","S","S","S","S","S","S","S","S","S","S","S","S","S","S","S","S","S","S","S","S","S","S","S","T",]
["P","U","U","U","U","U","U","U","U","U","U","U","U","U","U","U","U","U","U","U","U","U","U","U","U","U","U","U","U","U","U","U","U","U","U","U","U","U","U","U","U","U","U","U","U","U","U","U","U","U","U","U","U","U","U","U","U","U","U","T",]
["P","U","U","U","U","U","U","U","U","U","U","U","U","U","U","U","U","U","U","U","U","U","U","U","U","U","U","U","U","U","U","U","U","U","U","U","U","U","U","U","U","U","U","U","U","U","U","U","U","U","U","U","U","U","U","U","U","U","U","T",]
["P","U","U","U","U","U","U","U","U","U","U","U","U","U","U","U","U","U","U","U","U","U","U","U","U","U","U","U","U","U","U","U","U","U","U","U","U","U","U","U","U","U","U","U","U","U","U","U","U","U","U","U","U","U","U","U","U","U","U","T",]
["P","U","U","U","U","U","U","U","U","U","U","U","U","U","U","U","U","U","U","U","U","U","U","U","U","U","U","U","U","U","U","U","U","U","U","U","U","U","U","U","U","U","U","U","U","U","U","U","U","U","U","U","U","U","U","U","U","U","U","T",]
["P","U","U","U","U","U","U","U","U","U","U","U","U","U","U","U","U","U","U","U","U","U","U","U","U","U","U","U","U","U","U","U","U","U","U","U","U","U","U","U","U","U","U","U","U","U","U","U","U","U","U","U","U","U","U","U","U","U","U","T",]
["P","U","U","U","U","U","U","U","U","U","U","U","U","U","U","U","U","U","U","U","U","U","U","U","U","U","U","U","U","U","U","U","U","U","U","U","U","U","U","U","U","U","U","U","U","U","U","U","U","U","U","U","U","U","U","U","U","U","U","T",]
["P","U","U","U","U","U","U","U","U","U","U","U","U","U","U","U","U","U","U","U","U","U","U","U","U","U","U","U","U","U","U","U","U","U","U","U","U","U","U","U","U","U","U","U","U","U","U","U","U","U","U","U","U","U","U","U","U","U","U","T",]
["P","U","U","U","U","U","U","U","U","U","U","U","U","U","U","U","U","U","U","U","U","U","U","U","U","U","U","U","U","U","U","U","U","U","U","U","U","U","U","U","U","U","U","U","U","U","U","U","U","U","U","U","U","U","U","U","U","U","U","T",]
["P","U","U","U","U","U","U","U","U","U","U","U","U","U","U","U","U","U","U","U","U","U","U","U","U","U","U","U","U","U","U","U","U","U","U","U","U","U","U","U","U","U","U","U","U","U","U","U","U","U","U","U","U","U","U","U","U","U","U","T",]
["P","U","U","U","U","U","U","U","U","U","U","U","U","U","U","U","U","U","U","U","U","U","U","U","U","U","U","U","U","U","U","U","U","U","U","U","U","U","U","U","U","U","U","U","U","U","U","U","U","U","U","U","U","U","U","U","U","U","U","T",]
["P","U","U","U","U","U","U","U","U","U","U","U","U","U","U","U","U","U","U","U","U","U","U","U","U","U","U","U","U","U","U","U","U","U","U","U","U","U","U","U","U","U","U","U","U","U","U","U","U","U","U","U","U","U","U","U","U","U","U","T",]
["P","U","U","U","U","U","U","U","U","U","U","U","U","U","U","U","U","U","U","U","U","U","U","U","U","U","U","U","U","U","U","U","U","U","U","U","U","U","U","U","U","U","U","U","U","U","U","U","U","U","U","U","U","U","U","U","U","U","U","T",]
["P","U","U","U","U","U","U","U","U","U","U","U","U","U","U","U","U","U","U","U","U","U","U","U","U","U","U","U","U","U","U","U","U","U","U","U","U","U","U","U","U","U","U","U","U","U","U","U","U","U","U","U","U","U","U","U","U","U","U","T",]
["P","U","U","U","U","U","U","U","U","U","U","U","U","U","U","U","U","U","U","U","U","U","U","U","U","U","U","U","U","U","U","U","U","U","U","U","U","U","U","U","U","U","U","U","U","U","U","U","U","U","U","U","U","U","U","U","U","U","U","T",]
["P","U","U","U","U","U","U","U","U","U","U","U","U","U","U","U","U","U","U","U","U","U","U","U","U","U","U","U","U","U","U","U","U","U","U","U","U","U","U","U","U","U","U","U","U","U","U","U","U","U","U","U","U","U","U","U","U","U","U","T",]
["P","U","U","U","U","U","U","U","U","U","U","U","U","U","U","U","U","U","U","U","U","U","U","U","U","U","U","U","U","U","U","U","U","U","U","U","U","U","U","U","U","U","U","U","U","U","U","U","U","U","U","U","U","U","U","U","U","U","U","T",]
["P","U","U","U","U","U","U","U","U","U","U","U","U","U","U","U","U","U","U","U","U","U","U","U","U","U","U","U","U","U","U","U","U","U","U","U","U","U","U","U","U","U","U","U","U","U","U","U","U","U","U","U","U","U","U","U","U","U","U","T",]
["P","U","U","U","U","U","U","U","U","U","U","U","U","U","U","U","U","U","U","U","U","U","U","U","U","U","U","U","U","U","U","U","U","U","U","U","U","U","U","U","U","U","U","U","U","U","U","U","U","U","U","U","U","U","U","U","U","U","U","T",]
["P","U","U","U","U","U","U","U","U","U","U","U","U","U","U","U","U","U","U","U","U","U","U","U","U","U","U","U","U","U","U","U","U","U","U","U","U","U","U","U","U","U","U","U","U","U","U","U","U","U","U","U","U","U","U","U","U","U","U","T",]
["P","U","U","U","U","U","U","U","U","U","U","U","U","U","U","U","U","U","U","U","U","U","U","U","U","U","U","U","U","U","U","U","U","U","U","U","U","U","U","U","U","U","U","U","U","U","U","U","U","U","U","U","U","U","U","U","U","U","U","T",]
["P","U","U","U","U","U","U","U","U","U","U","U","U","U","U","U","U","U","U","U","U","U","U","U","U","U","U","U","U","U","U","U","U","U","U","U","U","U","U","U","U","U","U","U","U","U","U","U","U","U","U","U","U","U","U","U","U","U","U","T",]
["P","U","U","U","U","U","U","U","U","U","U","U","U","U","U","U","U","U","U","U","U","U","U","U","U","U","U","U","U","U","U","U","U","U","U","U","U","U","U","U","U","U","U","U","U","U","U","U","U","U","U","U","U","U","U","U","U","U","U","T",]
["P","U","U","U","U","U","U","U","U","U","U","U","U","U","U","U","U","U","U","U","U","U","U","U","U","U","U","U","U","U","U","U","U","U","U","U","U","U","U","U","U","U","U","U","U","U","U","U","U","U","U","U","U","U","U","U","U","U","U","T",]
["P","U","U","U","U","U","U","U","U","U","U","U","U","U","U","U","U","U","U","U","U","U","U","U","U","U","U","U","U","U","U","U","U","U","U","U","U","U","U","U","U","U","U","U","U","U","U","U","U","U","U","U","U","U","U","U","U","U","U","T",]
["P","U","U","U","U","U","U","U","U","U","U","U","U","U","U","U","U","U","U","U","U","U","U","U","U","U","U","U","U","U","U","U","U","U","U","U","U","U","U","U","U","U","U","U","U","U","U","U","U","U","U","U","U","U","U","U","U","U","U","T",]
["P","U","U","A","n","n","b","U","U","U","U","U","U","U","U","U","U","U","U","U","U","U","U","U","U","U","U","U","U","U","U","U","U","U","U","U","U","U","U","U","U","U","U","U","U","U","U","U","U","U","U","U","U","U","U","U","U","U","U","T",]
["P","U","U","I","g","g","w","U","U","U","U","U","U","U","U","U","U","U","U","U","U","U","U","U","U","U","U","U","U","U","U","U","U","U","U","U","U","U","U","U","U","U","U","U","U","U","U","U","U","U","U","U","U","U","U","U","U","U","U","T",]
["P","U","U","I","g","g","w","U","U","U","U","U","U","U","U","U","U","U","U","U","U","U","U","U","U","U","U","U","U","U","U","U","U","U","U","U","U","U","U","U","U","U","U","U","U","U","U","U","U","U","U","U","U","U","U","U","U","U","U","T",]
["P","U","U","C","o","o","G","U","U","U","U","U","U","U","U","U","U","U","U","U","U","U","U","U","U","U","U","U","U","U","U","U","U","U","U","U","U","U","U","U","U","U","U","U","U","U","U","U","U","U","U","U","U","U","U","U","U","U","U","T",]
["P","U","U","U","U","U","U","U","U","U","U","U","U","U","U","U","U","U","U","U","U","U","U","U","U","U","U","U","U","U","U","U","U","U","U","U","U","U","U","U","U","U","U","U","U","U","U","U","U","U","U","U","U","U","U","U","U","U","U","T",]
["P","U","U","U","U","U","U","U","U","U","U","U","U","U","U","U","U","U","U","U","U","U","U","U","U","U","U","U","U","U","U","U","U","U","U","U","U","U","U","U","U","U","U","U","U","U","U","U","U","U","U","U","U","U","U","U","U","U","U","T",]
["P","U","U","U","U","U","U","U","U","U","U","U","U","U","U","U","U","U","U","U","U","U","U","U","U","U","U","U","U","U","U","U","U","U","U","U","U","U","U","U","U","U","U","U","U","U","U","U","U","U","U","U","U","U","U","U","U","U","U","T",]
["P","U","U","U","U","U","U","U","U","U","U","U","U","U","U","U","U","U","U","U","U","U","U","U","U","U","U","U","U","U","U","U","U","U","U","U","U","U","U","U","U","U","U","U","U","U","U","U","U","U","U","U","U","U","U","U","U","U","U","T",]
["P","U","U","U","U","U","U","U","U","U","U","U","U","U","U","U","U","U","U","U","U","U","U","U","U","U","U","U","U","U","U","U","U","U","U","U","U","U","U","U","U","U","U","U","U","U","U","U","U","U","U","U","U","U","U","U","U","U","U","T",]
["P","U","U","U","U","U","U","U","U","U","U","U","U","U","U","U","U","U","U","U","U","U","U","U","U","U","U","U","U","U","U","U","U","U","U","U","U","U","U","U","U","U","U","U","U","U","U","U","U","U","U","U","U","U","U","U","U","U","U","T",]
["P","U","U","U","U","U","U","U","U","U","U","U","U","U","U","U","U","U","U","U","U","U","U","U","U","U","U","U","U","U","U","U","U","U","U","U","U","U","U","U","U","U","U","U","U","U","U","U","U","U","U","U","U","U","U","U","U","U","U","T",]
["P","U","U","U","U","U","U","U","U","U","U","U","U","U","U","U","U","U","U","U","U","U","U","U","U","U","U","U","U","U","U","U","U","U","U","U","U","U","U","U","U","U","U","U","U","U","U","U","U","U","U","U","U","U","U","U","U","U","U","T",]
["P","U","U","U","U","U","U","U","U","U","U","U","U","U","U","U","U","U","U","U","U","U","U","U","U","U","U","U","U","U","U","U","U","U","U","U","U","U","U","U","U","U","U","U","U","U","U","U","U","U","U","U","U","U","U","U","U","U","U","T",]
["P","S","S","S","S","S","S","S","S","S","S","S","S","S","S","S","S","S","S","S","S","S","S","S","S","S","S","S","S","S","S","S","S","S","S","S","S","S","S","S","S","S","S","S","S","S","S","S","S","S","S","S","S","S","S","S","S","S","S","T",]
]


WORDMAP_PATHS = {"P": ["pygame/Jogo_Base/assets/tiles0/tile_0036.png", "ground"],
"S": ["pygame/Jogo_Base/assets/tiles0/tile_0037.png", "ground"],
"T": ["pygame/Jogo_Base/assets/tiles0/tile_0038.png", "ground"],
"U": ["pygame/Jogo_Base/assets/tiles1/tile_0028.png", "ground"],
"A": ["pygame/Jogo_Base/assets/tiles1/tile_0170.png", "ground"],
"n": ["pygame/Jogo_Base/assets/tiles1/tile_0171.png", "ground"],
"b": ["pygame/Jogo_Base/assets/tiles1/tile_0172.png", "ground"],
"I": ["pygame/Jogo_Base/assets/tiles1/tile_0197.png", "ground"],
"g": ["pygame/Jogo_Base/assets/tiles1/tile_0198.png", "ground"],
"w": ["pygame/Jogo_Base/assets/tiles1/tile_0199.png", "ground"],
"C": ["pygame/Jogo_Base/assets/tiles1/tile_0224.png", "ground"],
"o": ["pygame/Jogo_Base/assets/tiles1/tile_0225.png", "ground"],
"G": ["pygame/Jogo_Base/assets/tiles1/tile_0226.png", "ground"],
}